+---+---+---+---+---+---+---+---+---+---+
|       |                       |       |
+   +---+   +---+   +   +   +   +   +   +
|   |       |       |   |   |   |   |   |
+   +   +---+   +---+   +   +   +---+   +
|   |   |       |       |   |           |
+   +---+   +---+   +---+   +---+---+   +
|           |       |               |   |
+   +---+---+---+---+---+---+---+   +   +
|                       |       |   |   |
+   +---+---+---+   +   +   +   +   +   +
|   |           |       |   |       |   |
+   +   +---+---+---+---+---+---+---+   +
|   |   |                               |
+   +   +   +---+---+---+---+---+---+   +
|   |   |   |           |               |
+   +   +   +   +---+   +   +---+---+   +
|   |   |   |   |       |   |           |
+---+   +   +---+   +---+   +   +---+   +
|                                   |   |
+---+---+---+---+---+---+---+---+---+---+