+---+---+---+---+---+---+---+---+---+---+
|       |                       |       |
+   +---+   +---+   +   +   +   +   +   +
|   |       |       |   |   |   |   |   |
+   +   +---+   +---+   +   +   +---+   +
|   |   |       |       |   |           |
+   +---+   +---+   +---+   +---+---+   +
|           |       |               |   |
+   +---+---+   +---+---+---+---+   +   +
|               |       |       |   |   |
+   +---+---+---+   +   +   +   +   +   +
|   |                   |   |       |   |
+   +   +---+---+---+---+---+---+---+   +
|   |   |                               |
+   +   +   +---+---+---+---+---+---+---+
|   |   |   |           |               |
+   +   +   +   +---+   +   +---+---+   +
|   |   |   |   |       |   |           |
+   +   +   +---+   +---+   +   +---+   +
|   |                               |   |
+---+---+---+---+---+---+---+---+---+---+